(2,0)
 e se se sw  s
 s nw nw  n  w
ne  s  h  e sw
se  n  w ne sw
ne nw nw  n  n